40 25
150 100
15 14 16 17 14 15 13 9 3 2 3 2 2 3 11 16 17 15 14 17 15 14 17 15 16 17 1 2 3 2 1 3 2 3 2 1 1 3 2 2
17 15 17 16 13 13 8 1 2 3 2 3 3 2 3 11 14 15 16 17 16 14 15 17 14 9 2 3 1 3 2 1 2 3 5 6 7 1 2 3
16 17 13 13 13 13 13 7 3 1 2 2 3 2 3 1 12 14 15 16 17 14 15 16 8 1 1 3 2 5 6 6 6 6 13 13 13 7 1 2
14 15 13 10 10 10 13 13 6 7 2 3 2 3 1 3 12 13 15 14 15 16 17 15 13 7 2 2 5 13 13 13 13 13 13 13 13 8 1 1
17 16 8 3 1 2 11 10 10 13 7 1 2 3 1 2 11 13 13 13 14 15 14 15 13 13 6 7 12 13 13 13 13 13 13 13 13 8 1 2
16 15 8 1 2 3 2 3 2 12 8 2 3 2 3 1 3 12 13 13 13 16 15 14 15 13 13 13 13 13 13 13 13 13 13 13 13 9 2 3
15 17 8 2 3 2 3 1 5 13 9 1 2 3 2 3 5 13 13 13 13 13 14 16 17 15 13 13 13 13 13 13 13 13 10 10 9 2 3 2
14 15 13 7 1 2 3 2 12 8 2 3 2 3 2 1 12 13 13 13 13 13 13 13 14 15 14 13 13 13 13 13 10 9 1 2 3 2 3 3
14 16 15 13 6 7 2 3 12 8 1 2 3 2 3 1 11 10 13 13 13 13 13 13 13 16 17 14 13 13 13 9 1 1 5 6 7 2 3 2
15 16 14 16 17 8 3 2 12 8 2 3 2 3 3 2 3 1 12 13 13 13 13 13 13 13 14 15 13 13 13 6 7 5 13 10 13 7 2 3
14 15 17 13 10 9 2 3 12 8 3 2 2 3 1 3 1 2 12 13 13 13 13 13 13 13 16 14 13 13 10 13 13 13 9 2 12 8 1 2
15 14 13 9 1 2 3 2 12 8 2 3 2 3 3 1 3 2 11 10 13 8 11 13 13 13 14 15 13 9 1 11 13 8 1 1 11 9 3 2
16 10 9 2 3 2 3 1 12 8 3 2 1 3 2 3 2 2 3 3 12 8 1 12 13 14 16 15 14 1 2 1 11 13 7 2 3 2 2 3
3 2 3 3 2 3 3 1 12 8 2 3 2 2 3 1 3 3 2 2 12 8 2 12 13 17 14 15 14 15 16 1 2 12 13 7 2 2 3 2
1 2 3 2 3 3 2 3 12 13 6 6 6 7 2 3 2 3 3 1 12 8 1 11 13 15 16 14 15 16 17 1 3 12 13 9 2 1 3 2
2 3 2 3 3 2 2 1 12 13 10 10 10 13 6 7 3 2 3 5 13 8 1 2 12 15 14 15 16 15 14 1 3 12 8 1 2 3 2 3
3 2 3 5 6 6 6 6 13 9 1 2 1 11 10 8 2 2 5 13 10 9 2 3 11 10 14 15 16 17 2 2 3 12 8 1 2 1 2 3
2 2 5 13 13 13 13 13 8 1 2 2 2 3 2 12 6 6 13 9 1 2 3 2 3 2 15 16 14 15 1 5 6 13 9 1 3 2 3 2
17 16 15 13 13 13 13 13 8 2 1 2 2 3 2 11 10 13 8 1 2 2 3 2 3 3 2 16 15 1 2 12 13 9 1 2 2 3 2 3
16 15 14 13 13 13 13 13 13 6 7 1 2 3 2 3 1 12 13 6 6 6 7 1 2 3 2 3 2 1 5 10 9 1 2 2 3 2 3 1
17 16 15 13 13 13 13 13 13 13 8 1 2 3 2 2 1 12 13 13 10 13 8 1 2 3 1 5 6 6 8 1 2 3 2 3 2 3 2 1
16 17 16 15 13 13 13 13 13 10 9 2 3 2 2 3 1 11 10 9 1 12 13 6 6 7 5 13 10 10 9 1 2 2 3 2 3 3 2 3
17 16 15 16 17 14 13 10 9 1 2 2 3 2 3 3 2 3 1 3 2 11 10 10 10 13 13 9 1 2 3 2 3 1 2 3 1 2 3 3
16 15 14 15 16 13 9 1 2 2 3 2 3 2 3 2 1 3 2 1 3 3 2 3 2 11 9 1 3 2 3 2 2 3 3 2 3 1 3 2
17 16 15 16 17 8 1 2 1 2 1 1 3 1 3 1 1 2 3 2 3 1 1 1 1 3 3 2 3 2 1 2 3 2 1 3 1 2 3 2

4 4 4 4 4 4 21 4 4 4 4 4 4 4 25 4 4 4 4 4 4 4 4 4 4 4 4 4 4 4 4 4 4 4 4 4 4 4 4 4
4 4 4 4 22 23 26 4 4 4 4 4 4 4 27 24 4 4 4 4 4 4 4 4 4 22 26 4 4 4 4 4 4 4 4 4 4 4 4 4
4 4 22 23 26 4 4 4 4 4 4 4 4 4 4 27 24 4 4 4 4 4 4 4 22 26 4 4 4 4 4 4 4 4 4 4 4 4 4 4
4 4 21 4 4 4 4 4 4 4 4 4 4 4 4 4 27 24 4 4 4 4 4 4 21 4 4 4 4 4 4 4 4 4 4 4 4 4 4 4
4 4 21 4 4 4 4 4 4 4 4 4 4 4 4 4 4 27 23 24 4 4 4 4 20 29 4 4 4 4 4 4 4 4 4 4 4 4 4 4
4 4 21 4 4 4 4 4 4 4 4 4 4 4 4 4 4 4 4 27 24 4 4 4 4 20 29 4 4 4 4 4 4 4 4 4 4 4 4 4
4 4 21 4 4 4 4 4 4 4 4 4 4 4 4 4 4 4 4 4 27 24 4 4 4 4 20 29 4 4 4 4 4 4 4 4 4 4 4 4
4 4 20 29 4 4 4 4 4 4 4 4 4 4 4 4 4 4 4 4 4 27 23 24 4 4 4 20 29 4 4 4 4 4 4 4 4 4 4 4
4 4 4 20 19 29 4 4 4 4 4 4 4 4 4 4 4 4 4 4 4 4 4 27 24 4 4 4 21 4 4 4 4 4 4 4 4 4 4 4
4 4 4 4 4 21 4 4 4 4 4 4 4 4 4 4 4 4 4 4 4 4 4 4 27 24 4 4 21 4 4 4 4 4 4 4 4 4 4 4
4 4 4 22 23 26 4 4 4 4 4 4 4 4 4 4 4 4 4 4 4 4 4 4 4 25 4 4 21 4 4 4 4 4 4 4 4 4 4 4
4 4 22 26 4 4 4 4 4 4 4 4 4 4 4 4 4 4 4 4 4 4 4 4 28 18 4 4 20 29 4 4 4 4 4 4 4 4 4 4
32 22 26 4 4 4 4 4 4 4 4 4 4 4 4 4 4 4 4 4 4 4 4 4 25 4 4 4 31 4 4 4 4 4 4 4 4 4 4 4
4 4 4 4 4 4 4 4 4 4 4 4 4 4 4 4 4 4 4 4 4 4 4 4 25 4 4 4 4 30 34 4 4 4 4 4 4 4 4 4
4 4 4 4 4 4 4 4 4 4 4 4 4 4 4 4 4 4 4 4 4 4 4 4 25 4 4 4 4 4 31 4 4 4 4 4 4 4 4 4
4 4 4 4 4 4 4 4 4 4 4 4 4 4 4 4 4 4 4 4 4 4 4 4 25 4 4 4 4 4 31 4 4 4 4 4 4 4 4 4
4 4 4 4 4 4 4 4 4 4 4 4 4 4 4 4 4 4 4 4 4 4 4 4 27 24 4 4 4 31 4 4 4 4 4 4 4 4 4 4
4 4 19 29 4 4 4 4 4 4 4 4 4 4 4 4 4 4 4 4 4 4 4 4 4 4 36 4 4 35 4 4 4 4 4 4 4 4 4 4
30 30 4 21 4 4 4 4 4 4 4 4 4 4 4 4 4 4 4 4 4 4 4 4 4 4 4 36 35 4 4 4 4 4 4 4 4 4 4 4
4 4 4 21 4 4 4 4 4 4 4 4 4 4 4 4 4 4 4 4 4 4 4 4 4 4 4 4 4 4 4 4 4 4 4 4 4 4 4 4
4 4 4 20 29 4 4 4 4 4 4 4 4 4 4 4 4 4 4 4 4 4 4 4 4 4 4 4 4 4 4 4 4 4 4 4 4 4 4 4
4 4 4 4 20 19 29 4 4 4 4 4 4 4 4 4 4 4 4 4 4 4 4 4 4 4 4 4 4 4 4 4 4 4 4 4 4 4 4 4
4 4 4 4 4 4 21 4 4 4 4 4 4 4 4 4 4 4 4 4 4 4 4 4 4 4 4 4 4 4 4 4 4 4 4 4 4 4 4 4
4 4 4 4 4 22 26 4 4 4 4 4 4 4 4 4 4 4 4 4 4 4 4 4 4 4 4 4 4 4 4 4 4 4 4 4 4 4 4 4
4 4 4 4 4 21 4 4 4 4 4 4 4 4 4 4 4 4 4 4 4 4 4 4 4 4 4 4 4 4 4 4 4 4 4 4 4 4 4 4

